.....................................................................................................................................................
.....................................................................................................................................................
.....................................................................................................................................................
.....................................................................................................................................................
.....................................................................................................................................................
.....................................................................................................................................................
.....................................................................................................................................................
.....................................................................................................................................................
......................ccc............................................................................................................................
.........................................................`###^..../####*.............................................................................
..................cc..............c????????..............[___]....{____}.............................................................................
...........????....../###*.......c.......................[__`##^..{_____###*.........................................................................
.....................{___}......c........................[__[__]..{________}.........................................................................
................./###____}...........................`##^[__[__]..{_________#*.......................................................................
.................{________####*......................[__][__[__]..{__________}.......................................................................
#################______________###############*.../###############____________######################################################################*
______________________________________________}...{_________________________________________________________________________________________________}
______________________________________________}vvv{_________________________________________________________________________________________________}