.......................................................o.....................................................
............................................ccccccccccco.....................................................
.......................................................o.....................................................
............................................ccccccccccco.....................................................
.......................................................o.....................................................
............................................ccccccccccco.....................................................
.......................................................o.....................................................
............................................oooooooooooo.....................................................
......................ccc....................................................................................
..............s.....................?o?o?o??.............`###^..../####*.....................................
..................cc.............c.....................k.[___]....{____}.........................s...........
......000..o???....../###*.......0.s.k..k..k.............[__`##^..{_____###*.................................
.....................{___}...............................[__[__]..{________}.................................
................./###____}...........................`###^__[__]..{_________###*..........k....k....k.....k..
.................{________####*......................[___]__[__]..{____________}.............................
#################______________###############*.../###############______________############################*
______________________________________________}...{_________________________________________________________}
______________________________________________}vvv{_________________________________________________________}