.....................................................................................................................................................
.....................................................................................................................................................
.....................................................................................................................................................
.....................................................................................................................................................
.....................................................................................................................................................
.....................................................................................................................................................
.....................................................................................................................................................
.....................................................................................................................................................
......................ccc...........cccccccc.........................................................................................................
....................................????????.............`###^..../####*.............................................................................
..................cc.............c.....................k.[___]....{____}.............................................................................
......000..????....../###*.......0...k..k..k.k...........[__`##^..{_____###*.........................................................................
.....................{___}...............................[__[__]..{________}.........................................................................
................./###____}...........................`##^[__[__]..{_________#*..........k....k....k.....k............................................
.................{________####*......................[__][__[__]..{__________}.......................................................................
#################______________###############*.../###############____________######################################################################*
______________________________________________}...{_________________________________________________________________________________________________}
______________________________________________}vvv{_________________________________________________________________________________________________}